00000000
02222220
02111120
02111120
02211220
00000000